Tell	S/S
me	S/S
In	S/S
how	S/S
what	S/S
suggest	S/S
can	S/S
way	S/S
strategy	S/S
could	S/S
would	S/S
should	S/S
moves	S/S
must	S/S
make	S/S
help	S/S
goes	S\NP/NP
reach	S\NP/NP
do	S/S
does	S/S
to	S/S
to	NP/NP
to	S/(S/NP)
to	(S\NP)/(S\NP)
do	(S\NP)/(S\NP)
do	S/S
cure	S/NP
save	(S/NP)/NP
their	NP/NP
I	S/S
a	S/S
card	N/N
give	((S/N)/N)\N
lend	((S/N)/N)\N
transfer	((S\NP)/NP)/NP
start	S/NP
game	NP
visiting	(S\NP)/NP
without	(S\NP)/(S\NP)
without	S/S
cant	S/(S\NP)/(S\NP)/NP
go	S\NP/NP
can	S/S
cant	S/S
plan	S/S
this	S/S
