how	S/S
can	S/S
player1	NP
go	(S\NP)/NP
to	NP
delhi	NP
what	S/S
should	S/S
player1	NP
do	(S\NP)/(S\NP)
to	(S\NP)/(S\NP)
reach	(S\NP)/NP
delhi	NP
must	S/S
I	S/S
cure	S/NP
could	S/S
we	S/S
do	S/S
Delhi	NP
card	NP\NP
take	((S\NP)/NP)/NP
does	S/S
How	S/S
can	S/S
I	S/S
make	S/S
a	S/S
research_station	S/NP
in	NP/NP
Delhi	NP
build	S/S
create	S/S
setup	S/S
start	S/NP
the	NP/NP
begin	S/NP
